15 15
3 0 0 7 0 0 0 0 0 0 0 0 0 0 0
0 0 0 0 0 0 0 4 0 0 0 0 0 0 0
0 0 9 0 0 0 0 0 0 0 0 0 0 0 0
0 0 0 0 0 0 0 0 0 0 0 0 0 0 0
0 0 0 0 0 0 0 0 0 0 0 0 0 0 0
0 0 0 0 1 0 0 0 0 1 0 0 0 0 0
0 0 0 0 1 0 0 4 4 1 0 0 0 0 0
0 0 0 0 1 0 0 8 0 1 0 0 0 0 0
0 0 0 0 1 0 4 0 0 1 0 0 0 0 0
0 0 0 0 1 0 0 0 2 1 0 0 0 0 0
1 1 1 1 1 1 1 1 1 1 1 1 1 1 0
0 0 0 0 0 0 0 0 0 0 0 0 0 9 0
0 1 1 1 1 1 1 1 1 1 1 1 1 1 1
0 1 4 0 0 0 1 0 0 0 1 2 0 0 0
0 0 0 0 1 0 0 0 1 0 0 0 1 0 5