18 24
0 0 0 0 0 0 0 0 0 0 0 0 0 0 0 0 0 0 0 0 4 0 0 0
1 1 1 1 0 1 1 1 1 1 1 1 1 0 1 1 1 1 1 1 0 1 0 1
0 0 0 0 0 0 0 0 0 0 0 4 1 0 1 0 0 0 9 1 0 1 0 1
0 1 1 1 1 1 0 1 1 1 1 0 1 0 1 0 1 1 0 1 0 0 0 1
3 1 0 0 0 0 0 1 0 0 0 0 1 0 0 0 0 0 0 1 0 1 0 1
1 1 0 1 1 1 1 1 1 1 1 0 1 1 1 1 1 1 0 1 0 1 2 1
0 0 0 1 0 0 0 0 0 0 0 0 1 1 0 0 0 0 0 0 0 1 1 1
0 1 0 1 1 1 0 1 1 1 1 1 1 1 0 1 0 1 0 1 0 1 0 1
2 1 0 1 0 0 0 1 0 0 0 0 0 0 0 1 4 1 0 1 0 0 0 1
1 1 0 1 0 1 4 1 0 1 8 1 0 1 0 1 1 1 0 1 0 1 0 1
0 1 0 1 0 0 0 0 0 0 0 0 0 1 0 0 0 0 0 1 1 1 0 1
0 0 0 0 0 0 0 0 1 1 1 1 0 1 1 1 1 1 1 1 1 0 0 1
0 1 1 1 1 1 1 0 0 0 0 0 0 0 0 0 0 0 0 0 0 0 1 1
0 1 5 0 0 0 1 0 1 1 1 1 1 1 1 1 1 1 1 1 1 0 1 0
1 1 1 1 1 0 1 0 0 0 0 0 0 0 0 0 0 0 0 0 0 0 0 0
0 0 0 0 0 0 1 0 1 1 1 0 1 1 1 1 1 1 1 1 1 0 1 1
0 1 1 1 1 1 1 0 1 9 0 0 0 0 0 1 7 0 0 0 0 0 0 0
4 0 0 0 0 0 0 0 1 1 1 1 1 1 1 1 1 1 1 1 1 1 1 1