39 21
1 1 1 1 1 1 1 1 1 1 1 1 1 1 1 1 1 1 1 1 1
1 3 0 0 0 0 0 0 0 0 1 0 0 0 0 0 1 4 0 0 1
1 1 1 1 1 1 1 0 1 1 1 0 1 1 1 1 1 1 1 0 1
1 0 0 0 0 0 0 0 1 0 0 0 1 2 0 0 0 0 1 0 1
1 1 1 1 1 0 1 1 1 1 1 0 1 1 1 0 1 0 1 0 1
1 0 0 0 1 0 1 0 0 0 0 0 0 0 0 0 1 0 0 0 1
1 0 1 2 1 0 1 0 1 1 1 1 0 1 1 1 1 1 1 1 1
1 0 1 1 1 0 1 0 0 0 0 1 0 1 9 0 0 0 0 0 1
1 0 1 0 0 0 0 0 1 7 1 0 0 1 1 0 1 1 1 1 1
1 0 1 0 1 1 1 1 1 1 1 1 0 0 0 0 1 0 0 0 1
1 0 1 0 0 0 0 0 0 0 0 1 1 0 1 1 1 1 1 0 1
1 0 1 1 1 1 1 1 1 1 0 0 1 0 1 0 0 0 0 0 1
1 0 1 0 0 0 0 0 0 0 1 0 1 0 1 0 1 1 1 1 1
1 0 0 0 1 0 1 1 1 0 1 4 1 0 1 0 1 0 0 0 1
1 1 1 1 1 0 1 2 1 0 1 1 1 0 1 0 1 1 1 0 1
1 0 0 0 0 0 1 0 1 0 0 0 0 0 0 0 0 0 0 0 1
1 0 1 1 1 0 1 0 1 1 1 1 1 0 1 1 1 1 1 0 1
1 0 1 0 0 0 1 0 0 0 0 0 1 0 1 0 0 0 1 6 1
1 0 1 1 1 0 1 0 1 1 1 1 1 0 1 0 1 0 1 1 1
1 9 0 0 1 0 1 0 0 0 0 0 0 0 1 8 1 0 0 0 1
1 1 1 0 1 1 1 1 1 1 1 1 1 1 1 1 1 0 1 0 1
1 4 1 0 1 0 0 0 0 0 0 0 0 0 0 0 1 0 1 0 1
1 0 1 0 1 0 1 0 0 0 1 1 1 0 1 0 1 0 1 0 1
1 0 1 0 1 0 1 0 1 1 1 0 0 0 1 1 1 0 1 1 1
1 0 1 0 0 0 1 0 1 4 1 1 1 0 0 0 1 0 0 0 1
1 0 1 0 1 0 1 0 1 0 0 0 1 1 1 0 1 1 1 0 1
1 0 0 0 1 0 0 0 1 0 1 0 0 0 1 0 0 0 1 0 1
1 0 1 1 1 0 1 0 0 0 1 0 1 0 1 0 1 1 1 0 1
1 0 1 6 0 0 1 0 1 1 1 0 1 1 1 0 0 0 0 0 1
1 0 1 1 1 0 1 1 1 0 0 0 0 0 0 0 1 1 1 1 1
1 0 0 0 1 0 0 0 0 0 1 1 1 1 1 0 1 0 0 0 1
1 1 1 0 1 1 1 1 1 0 1 0 0 0 0 0 1 0 1 0 1
1 5 1 0 1 0 0 0 1 0 1 1 1 1 1 1 1 0 1 0 1
1 0 1 1 1 0 1 0 1 0 0 0 0 0 0 0 1 0 0 0 1
1 0 0 0 1 0 1 0 1 0 1 1 1 1 1 0 1 0 1 0 1
1 0 1 0 1 0 1 0 1 0 1 0 0 2 1 0 1 0 1 0 1
1 0 1 0 1 0 1 0 1 1 1 0 1 0 1 0 1 0 1 1 1
1 0 1 0 0 0 1 0 0 0 0 0 1 0 0 0 0 0 0 4 1
1 1 1 1 1 1 1 1 1 1 1 1 1 1 1 1 1 1 1 1 1