10 40
0 1 0 1 0 1 0 0 0 1 0 0 0 0 0 1 1 0 0 1 0 0 1 0 1 0 0 0 1 1 1 0 1 1 9 1 1 1 1 0 
0 4 0 1 0 1 0 0 1 1 0 0 0 0 0 1 0 0 0 0 0 0 0 1 0 9 1 0 0 0 0 0 2 0 1 3 1 1 4 0 
0 1 0 0 0 1 1 0 0 1 0 1 1 1 1 0 0 0 0 0 0 0 1 0 0 1 0 1 1 1 0 1 1 0 1 0 1 0 0 0 
1 0 1 1 4 0 0 0 1 1 1 1 0 1 1 0 0 1 1 0 0 0 1 1 0 0 0 0 0 1 0 0 0 1 0 0 1 0 1 1 
0 1 1 0 1 0 0 1 1 0 0 1 0 0 1 1 1 0 0 0 1 1 0 0 1 0 1 1 1 0 1 1 1 0 1 0 0 0 0 7 
1 1 0 1 0 0 2 0 0 1 1 0 1 1 0 1 0 1 1 1 4 1 0 0 0 0 1 1 0 1 0 0 0 1 6 0 1 1 1 1 
0 1 1 1 0 1 0 1 1 1 0 0 1 1 1 0 1 1 0 1 0 0 1 1 0 1 0 1 1 1 1 0 0 1 1 0 0 1 0 1 
1 0 0 1 1 4 1 0 1 1 1 1 0 1 0 1 0 1 1 0 1 1 1 0 0 1 1 1 1 0 0 0 1 0 1 0 0 1 0 0 
1 1 1 1 0 1 0 1 0 0 1 8 0 1 0 0 0 1 1 1 0 0 1 0 0 1 0 0 1 0 0 0 1 1 1 0 5 1 0 1 
1 0 1 1 0 1 0 1 1 0 0 1 1 1 0 1 0 1 0 0 0 0 0 1 1 1 1 1 1 1 0 1 0 1 0 1 1 1 1 1 
