15 22 
0 0 0 1 1 1 1 1 1 1 1 1 1 1 1 1 0 0 0 0 1 0
0 3 0 0 0 0 0 0 0 0 0 0 0 0 2 1 0 1 1 0 1 0
0 0 0 0 1 1 1 0 1 1 1 0 1 1 1 1 0 1 0 0 1 0
1 0 1 0 0 0 1 0 0 8 1 0 1 0 0 1 0 1 0 0 1 0
1 0 1 1 1 0 1 0 1 1 1 4 0 0 1 1 0 1 0 1 1 0
1 0 1 0 0 0 1 0 0 0 0 0 1 0 1 1 0 1 0 1 0 0
1 0 1 0 4 0 1 1 1 1 0 1 1 0 9 1 0 1 0 1 0 0
1 0 1 0 0 0 0 0 0 0 0 1 1 1 1 1 0 1 0 0 4 0
1 0 1 1 1 0 1 9 1 0 1 0 0 0 0 0 0 1 0 1 1 0
1 0 1 1 1 1 1 1 1 0 1 1 1 1 1 1 0 1 0 1 0 0
1 0 0 0 0 0 0 0 0 0 1 0 0 0 5 1 0 1 0 0 0 0
1 0 1 1 1 1 1 1 1 0 1 0 1 1 1 1 0 1 0 0 0 0
1 0 1 1 2 0 0 1 1 0 1 0 0 0 0 0 0 1 0 0 1 1
1 7 1 0 1 0 1 9 1 4 1 1 1 1 1 1 1 1 0 1 1 1
1 1 1 0 0 0 0 0 0 0 0 0 0 0 0 0 0 0 0 1 1 4