12 12
1 1 1 1 1 1 1 1 1 1 1 1 
1 3 1 7 1 0 1 0 0 0 0 1
1 0 0 0 1 1 0 0 0 0 0 1
1 0 0 1 0 0 0 1 1 2 0 1
1 0 0 0 1 0 0 9 1 4 4 1
1 0 1 1 1 1 0 1 0 1 1 1
1 0 0 0 0 0 0 0 0 0 0 1 
1 1 1 1 1 1 1 1 1 0 0 1
1 5 0 0 1 9 0 4 1 0 0 1
1 1 0 1 1 1 0 1 1 0 1 1
1 1 0 8 4 0 0 0 0 0 1 1 
4 0 0 0 0 0 0 0 2 0 0 0 